b b b b b b b b b b b
b b b b b b b b b b b
r r r r r r r gLgPb b
gpb b b b b b b b b b
b b b b b b b b b b b
b b gPp p p p p p p p
