r r r r r r r r
b b b b b b b b
y y y y y y y y
r r r r r r r r
b b b b b b b b
y y y y y y y y
r r r r r r r r
b b b b b b b b
ysysysglglglpppp
      bl